414114444412144
112551416114111
E14414154454141
1125151461511D1
444614444451444
