44416114X444444
451144141451E44
114441111114111
651115114644146
WD6144451111511
