44441644416Z444
444151111146114
E11U44154541454
414514516511D14
411114114614444
