414416144411144
114151116114111
E11114411454141
1115144161511D1
111614411451444
