44441644416U444
444151111146114
E11Z44154541454
414514516511D14
411114114614444
