4E444V4111116Y4
411546464154144
4141114D6114111
414115144414454
451114111151111
