414114444411144
111551416114111
E14414154454141
1115151461511D1
444614444451444
