414416144412144
114251116114111
E11114411454141
1115144161511D1
211614411451444
